1111111111111111111111111111111
1222222222211222222211222222221
1211111111211211111222211211121
1211111111211211111122111222221
1222222211211221111221111111121
1211111211211121112211111111121
1211111211222222222111111111121
1211111211211111112111111122221
1211122222211111112221111221111
1222221121111111111121111211111
1211121122222222222221111222221
1222221121111111111122111111121
1111122222222222222222222222221
1111121111211155111212111111111
4222221111210000001212111112224
1111121111210000001212222112111
1111121111211111111212112222221
1222121111222222222222112112111
1212122222211111111112112112111
1212121111122222222222112222111
1212222222221211212112222112221
121